40
40
20 20 20 20 20 20 20 20 20 20 20 20 20 20 20 20 20 20 20 20 20 20 20 20 20 20 20 20 20 20 20 20 20 20 20 20 20 20 20 20
20 20 20 20 03 01 20 20 20 20 20 20 20 20 20 20 20 20 20 20 20 20 20 20 20 20 20 20 20 20 20 20 20 20 20 20 20 20 20 20 
20 20 02 01 01 02 01 01 20 20 02 01 02 20 20 20 20 20 20 20 20 01 01 01 01 20 20 20 20 20 20 01 01 01 01 01 01 20 20 20 
20 20 01 01 02 01 01 03 01 01 01 22 22 22 20 20 20 20 20 20 01 01 03 02 01 01 20 20 20 20 01 03 01 02 01 02 01 01 20 20 
20 20 01 01 03 01 01 01 01 03 22 22 22 22 20 20 20 20 20 01 02 01 01 01 01 01 01 22 22 01 01 03 01 01 01 03 01 01 20 20 
20 20 02 01 01 01 02 01 02 02 22 22 22 22 20 20 20 20 20 01 01 01 01 01 01 02 01 22 22 01 01 01 03 01 02 01 01 20 20 20 
20 20 20 03 01 20 20 20 20 02 22 22 22 20 20 20 20 20 01 01 03 03 01 20 20 01 01 22 22 22 01 01 02 01 01 01 20 20 20 20 
20 20 20 20 20 20 20 20 20 20 22 22 22 20 20 20 20 20 01 01 20 20 20 20 20 20 20 22 22 22 20 20 20 20 20 20 20 20 20 20 
20 20 20 20 20 20 20 20 20 20 22 22 22 20 20 20 20 20 01 01 20 20 20 20 20 20 20 22 22 22 20 20 20 20 20 20 20 20 20 20 
20 20 20 20 20 20 20 20 20 01 03 22 22 01 01 20 20 20 01 03 20 20 20 20 20 20 22 22 22 22 20 20 20 20 20 20 20 20 20 20 
20 20 20 01 01 01 01 20 20 01 01 22 22 22 01 20 20 01 01 01 01 20 20 20 20 22 22 22 22 22 20 20 20 20 01 01 20 20 20 20 
20 20 01 01 03 01 01 20 20 01 22 22 22 22 02 20 20 01 02 01 01 01 20 20 20 22 22 22 22 20 20 20 20 01 03 01 01 20 20 20 
20 20 01 03 01 03 01 01 01 01 22 22 22 22 01 01 01 01 01 02 01 02 20 20 20 22 22 20 20 20 20 20 20 01 02 01 01 03 20 20 
20 20 01 01 03 01 01 20 20 01 22 22 22 01 03 01 03 01 03 01 01 01 20 20 20 03 01 20 20 01 01 03 01 01 02 01 01 01 20 20 
20 20 20 01 01 01 01 20 20 03 01 22 22 02 01 20 20 02 01 01 01 20 20 20 20 01 02 01 20 01 20 20 20 01 01 01 01 20 20 20 
20 20 20 20 01 20 20 20 20 20 20 20 20 20 02 20 20 20 20 20 20 20 20 20 20 20 20 01 20 02 20 20 20 20 20 01 02 20 20 20 
20 20 20 20 01 20 20 20 20 20 20 20 20 20 01 20 20 20 20 20 20 20 20 20 20 20 20 01 20 01 20 20 20 20 20 01 01 20 20 20 
20 20 20 20 01 20 20 20 20 20 20 01 01 02 01 20 20 01 01 01 01 01 01 20 20 02 03 01 20 01 20 20 20 20 20 03 01 20 20 20 
20 20 02 03 01 20 20 20 20 20 01 03 20 20 20 20 20 01 01 03 01 02 01 20 20 01 20 20 20 02 01 20 20 20 20 01 01 20 20 20 
20 20 01 20 20 20 20 20 20 01 01 20 20 20 20 20 20 01 02 01 01 03 01 20 20 03 01 02 20 20 01 20 20 20 20 20 01 20 20 20 
20 20 03 02 01 02 01 03 01 02 01 20 20 20 01 01 01 01 01 02 01 02 01 20 20 01 20 01 03 01 01 20 20 20 20 20 02 20 20 20 
20 20 20 20 20 20 20 20 20 01 01 01 20 20 20 20 20 01 03 02 01 01 03 20 20 02 20 20 20 20 20 20 20 20 20 20 01 20 20 20 
20 20 20 20 20 20 20 20 20 20 03 01 20 20 20 20 20 03 01 01 01 01 01 20 20 01 01 03 01 03 01 20 20 20 20 20 03 20 20 20 
20 20 20 20 20 20 20 20 20 20 20 01 20 20 20 20 20 20 20 20 20 20 20 20 20 20 20 20 20 20 01 20 20 20 20 20 01 20 20 20 
20 20 20 20 20 20 20 20 20 20 20 01 20 20 20 20 20 20 20 01 01 20 20 20 20 20 20 20 20 20 01 20 20 20 20 20 01 20 20 20 
20 20 20 20 20 20 20 20 20 20 20 01 22 20 20 20 20 20 01 01 01 20 20 20 20 20 20 03 01 01 01 20 20 20 20 20 01 03 01 20 
20 20 20 01 03 20 20 20 20 01 02 01 22 22 20 20 20 20 01 02 01 03 20 20 20 20 01 01 02 01 01 20 20 20 20 20 03 01 03 20 
20 20 01 01 01 02 01 20 01 01 03 22 22 22 22 20 20 20 01 03 01 02 20 20 20 02 01 03 01 01 01 03 01 03 20 20 20 03 20 20 
20 20 01 02 01 02 03 20 01 01 22 22 22 22 01 20 20 01 02 01 03 02 20 20 20 01 01 02 01 03 01 01 02 01 02 20 20 20 20 20 
20 20 20 01 01 01 01 20 20 20 22 22 22 03 01 01 01 03 01 01 01 01 20 20 20 03 01 01 02 01 20 20 20 03 01 22 22 22 22 20 
20 20 20 03 01 02 01 20 20 20 20 22 22 20 20 20 20 01 20 20 20 01 01 01 01 01 03 01 01 20 20 20 20 01 22 22 22 22 22 20 
20 20 20 02 01 20 20 20 20 20 20 20 20 20 20 20 20 20 20 20 20 20 20 20 20 20 20 20 20 20 20 20 20 20 20 22 22 22 22 20 
20 20 20 01 01 20 20 20 20 20 20 20 20 20 20 20 20 01 20 20 20 01 20 20 20 20 20 20 20 20 20 20 20 20 20 22 22 22 22 20 
20 20 20 01 01 20 20 20 20 20 20 20 20 20 01 01 01 03 20 20 20 01 01 01 01 03 01 20 20 20 20 20 20 20 22 22 22 22 22 20 
20 20 01 03 01 20 20 20 20 20 20 03 01 01 02 20 20 20 20 20 20 01 03 01 01 01 02 01 20 20 20 20 20 20 22 22 22 22 22 20 
20 20 02 01 01 20 20 20 20 20 20 02 20 20 20 20 20 20 20 20 01 02 01 03 01 03 01 03 01 20 20 20 20 20 22 22 22 22 22 20 
20 20 01 01 02 01 20 20 20 20 20 01 20 20 20 20 20 20 20 20 01 01 01 01 02 01 02 01 01 20 20 20 20 20 20 22 22 22 20 20 
20 20 20 01 03 01 01 01 01 01 02 01 20 20 20 20 20 20 20 20 20 03 01 01 03 01 02 01 20 20 20 20 20 20 20 01 01 01 20 20 
20 20 20 20 01 02 20 20 20 20 20 20 20 20 20 20 20 20 20 20 20 20 20 20 20 01 01 20 20 20 20 20 20 20 20 20 01 20 20 20 
20 20 20 20 20 20 20 20 20 20 20 20 20 20 20 20 20 20 20 20 20 20 20 20 20 20 20 20 20 20 20 20 20 20 20 20 20 20 20 20 
